%%%%%%%%%%%%%%%
%P........E.E.%
%%%%%.o%%%%%%%%
%%....oo...%o%%
%%.%%%.....%o%%
%%o%.%....o%o%%
%.E%.........%%
%....%.%%%%%.%%
%G%%%%.oooo%E%%
%%%%%%%%%%%%%%%
