%%%%%%%%%%%%%%%
%P........E.E.%
%%%%%..%%%%%%%%
%%.........%o%%
%%.%%%.....%o%%
%%o%.%.....%o%%
%.E%.........%%
%....%.%%%%%.%%
%G%%%%.oooo%E%%
%%%%%%%%%%%%%%%
