%%%%%%%%%%%%%%%%%%%%G%%%%%%%%%%%%%%%%%%%%
%%%..%%%%%%%%%,-o....%%%%.oo.%%%%%%.oo.%%
%%%.%%%.E.o,,..%%%%..o.o..%%%..%..%%%%%%%
%%%%%%%.%%%%%%.,.-%.%%.%%,.%%%.E..%%%%%%%
%..%.,,.E..-.%%%.%%.%%.%%%.o%%%%%.G%%..%%
%..%.%%.%%.,.%%%.%%..E....%.-.%%%.%%%..%%
%%%%P%%%%%.%%.ooo.,-,%%%...%%.,.E.%%%..%%
%%%%%%%%%%%%%%%%%%%%%%%%%%%%%%%%%%%%%%%%%
