%%%%%%%%%%%%%%%%%%%%%%%%%%%%%%%%%%%%%%%%%
%-o-o-o-o-o-o-%%%%%%%%%%%%%%.o.o.o.o.o.o%
%%%%%%%%%%%%%.,,,,,,,,,,,,,,.%%%%%%%%%%%%
P.............,,----EE----,,............G
%%%%%%%%%%%%%.,,----EE----,,.%%%%%%%%%%%%
%%%%%%%%%%%%%.,,,,......,,,,.%%%%%%%%%%%%
%E............%%%%%%%%%%%%%%,o,o,o,o,o,o%
%%%%%%%%%%%%%%%%%%%%%%%%%%%%%%%%%%%%%%%%%
