%%%%%%%%%%%%%%%%%%%%G%%%%%%%%%%%%%%%%%%%%
%%%..%%%%%%%%%,-o....%%%%.oo.%%%%%%.oo.%%
%%%.%%%.E.o,,..%%%%..o.o..%%%..%..%%%%%%%
%%%%%%%.%%%%%%.,.-%.%%.%%,.%%%.E..%%%%%%%
%..%.,,.E..-.%%%.%%.%%.%%%.o%%%%%..%%..%%
%..%.%%.%%.,.%%%.%%..E....%.-.%%%.%%%..%%
%%%%.%%%%%.%%.ooo.,-,%%%...%%.,.E.%%%..%%
%%%%P%%%%%%%%%%%%%%%%%%%%%%%%%%%%%%%%%%%%
