%%%%%%%%%%%%%%%%%%%%%%%%%%%%%%%%%%%%%%%%%
%P,.,.%%%%%.ooo.,.%%%%%%%.,..,...%%....%%
%%%%%.%%%...%%%%%.,,.E.-.-.%%.%%.%%%%%.%%
%%%-o.%%%.%.%%.-.%E%.%.%E%.%%.%%......E%%
%o%-%..E..%.%..%.%..E..,--.%%o%%%o%o%o%%%
%.%.%%%%%%%.%%%%.%.%%%%%%.%%%.%%%.%.%.%%%
%-.o,E.o,.E..o...%.-.,%%%.-.o,.E..%..,-G%
%%%%%%%%%%%%%%%%%%%%%%%%%%%%%%%%%%%%%%%%%
