%%%%%%%%%%
%    G  P%
%%%%%%%%%%
