%%%%%%%%%%
%G......P%
%%%%%%%%%%
