%%%%%%%%%%
%G      P%
%%%%%%%%%%
